num_pellets 1850
pacman_home (30 * 16, 25 * 16)
ghost_home [(30 * 16, 17 * 16), (29 * 16, 19 * 16), (30 * 16, 19 * 16), ( 31 * 16, 19 * 16)]
level_dim (61, 39)
color_edge (0, 0, 255, 255)
color_fill (0, 0, 0, 255)
color_shadow (0, 0, 128, 255)
color_pellet (255, 255, 255, 255)
107 100 100 100 100 100 100 100 100 100   0 107 100 100 100 100 100 100 100 100   0 100 100 100 100 100 100 100 100 112   0 111 100 100 100 100 100 100 100 100   0 100 100 100 100 100 100 100 100 100   0 100 100 100 100 100 100 100 100 100 108
101   3   2   2   2   2   2   2   2   2   2 101   2   2   2   2   2   2   2   2   2   2   2   2   2   2   2   2   2   2   2   2   2   2   2   2   2   2   2   2   2   2   2   2   2   2   2   2   2   2   2   2   2   2   2   2   2   2   2   3 101
101   2 107 100 100 112   2 111 100 100 100 106   2   2   2   2   2   2   2   2   2   2   2   2   2   2   2   2 111 100 133 100 112   2   2   2   2   2   2   2   2   2   2   2   2   2   2   2   2   2   2   2   2   2   2   2   2   2   2   2 101
101   2 101   2   2   2   2   2   2   2   2   2   2   2   2   2   2   2   2   2   2   2   2   2   2   2   2   2   2   2 101   2   2   2   2   2   2   2   2   2   2   2   2   2   2   2   2   2   2   2   2   2   2   2   2   2   2   2   2   2 101
101   2   2   2   2   2   2   2   2   2   2   2   2   2   2   2   2   2   2   3   2   2   2   2   3   2   2   2   2   2 110   2   2   2   2   2   3   2   2   2   2   3   2   2   2   2   2   2   2   2   2   2   2   2   2   2   2   2   2   2 101
101   2   2   2   2   2   2   2   2   2   2   2   2   2   2   2   2   2   2   2   2   2   2   2   2   2   2   2   2   2   2   2   2   2   2   2   2   2   2   2   2   2   2   2   2   2   2   2   2   2   2   2   2   2   2   2   2   2   2   2 101
101   2   2   2   2   2   2   2   2   2   2   2   2   2   2   2   2   2   2   2   2   2   2   2   2   2   2   2 111 100 133 100 112   2   2   2   2   2   2   2   2   2   2   2   2   2   2   2   2   2   2   2   2   2   2   2   2   2   2   2 101
101   3   2   2   2   2   2   2   2   2   2   2   2   2   2   2   2   2   2   2   2   2   2   2   2   2   2   2   2   2 101   2   2   2   2   2   2   2   2   2   2   2   2   2   2   2   2   2   2   2   2   2   2   2   2   2   2   2   2   3 101
101   2   2   2   2   2   2   2   2   2   2   2   2   2   2   2   2   2   2   2   2   2   2   2   2   2   2   2   2   2 110   2   2   2   2   2   2   2   2   2   2   2   2   2   2   2   2   2   2   2   2   2   2   2   2   2   2   2   2   2 101
101   2   2   2   2   2   2   2   2   2   2   2   2   2   2   2   2   2   2   2   2   2   2   2   3   2   2   2   2   2   2   2   2   2   2   2   3   2   2   2   2   2   2   2   2   2   2   2   2   2   2   2   2   2   2   2   2   2   2   2 101
101   2   2   2   2   2   2   2   2   2   2   2   2   2   2   2   2   2   2   3 107 100 100 100 112   2   2   2 111 100 133 100 112   2   2   2 111 100 100 100 108   3   2   2   2   2   2   2   2   2   2   2   2   2   2   2   2   2   2   2 101
101   2   2   2   2   2   2   2   2   2   2   2   2   2   2   2   2   2   2   2 101   2   2   2   2   2   2   2   2   2 101   2   2   2   2   2   2   2   2   2 101   2   2   2   2   2   2   2   2   2   2   2   2   2   2   2   2   2   2   2 101
101   2   2   2   2   2   2   2   2   2   2   2   2   2   2   2   2   2   2   2 101   3 111 100 112   2 111 100 112   2 110   2 111 100 112   2 111 100 112   3 101   2   2   2   2   2   2   2   2   2   2   2   2   2   2   2   2   2   2   2 101
101   3   2   2   2   2   2   2   2   2   2   2   2   2   2   2   2   2   2   2 101   2   2   2   2   2   2   2   2   2   2   2   2   2   2   2   2   2   2   2 101   2   2   2   2   2   2   2   2   2   2   2   2   2   2   2   2   2   2   3 101
101   2   2   2   2   2   2   2   2   2   2   2   2   2   2   2   2   2   2   2 101   2 111 100 112   2 113   2 111 100 133 100 112   2 113   2 111 100 112   2 101   2   2   2   2   2   2   2   2   2   2   2   2   2   2   2   2   2   2   2 101
101   2   2   2   2   2   2   2   2   2   2   2   2   2   2   2   2   2   2   2 101   2   2   2   2   2 101   2   2   2 101   2   2   2 101   2   2   2   2   2 101   2   2   2   2   2   2   2   2   2   2   2   2   2   2   2   2   2   2   2 101
101   2   2   2   2   2   2   2   2   2   2   2   2   2   2   2   2   2   2   3 131 100 100 100 108   2 131 100 112   0 110   0 111 100 132   2 107 100 100 100 132   3   2   2   2   2   2   2   2   2   2   2   2   2   2   2   2   2   2   2 101
101   2   2   2   2   2   2   2   2   2   2   2   2   2   2   2   2   2   2   2 110   2   2   2 101   2 101   0   0   0   0   0   0   0 101   2 101   2   2   2 110   2   2   2   2   2   2   2   2   2   2   2   2   2   2   2   2   2   2   2 101
101   2   2   2   2   2   2   2   2   2   2   2   2   2   2   2   2   2   2   2   2   2 113   2 110   2 110   0 107 100   1 100 108   0 110   2 110   2 113   2   2   2   2   2   2   2   2   2   2   2   2   2   2   2   2   2   2   2   2   2 101
  0   3   2   2   2   2   2   2   2   2   2   2   2   2   2   2   2   2   2   2 111 100 132   2   2   2   0   0 101   0   0   0 101   0   0   2   2   2 131 100 112   2   2   2   2   2   2   2   2   2   2   2   2   2   2   2   2   2   2   3   0
101   2   2   2   2   2   2   2   2   2   2   2   2   2   2   2   2   2   2   2   2   2 110   2 113   2 113   0 105 100 100 100 106   0 113   2 113   2 110   2   2   2   2   2   2   2   2   2   2   2   2   2   2   2   2   2   2   2   2   2 101
101   2   2   2   2   2   2   2   2   2   2   2   2   2   2   2   2   2   2   2 113   2   2   2 101   2 101   0   0   0   0   0   0   0 101   2 101   2   2   2 113   2   2   2   2   2   2   2   2   2   2   2   2   2   2   2   2   2   2   2 101
101   2   2   2   2   2   2   2   2   2   2   2   2   2   2   2   2   2   2   3 131 100 100 100 106   2 110   0 111 100 133 100 112   0 110   2 105 100 100 100 132   3   2   2   2   2   2   2   2   2   2   2   2   2   2   2   2   2   2   2 101
101   2   2   2   2   2   2   2   2   2   2   2   2   2   2   2   2   2   2   2 101   2   2   2   2   2   2   2   2   2 101   2   2   2   2   2   2   2   2   2 101   2   2   2   2   2   2   2   2   2   2   2   2   2   2   2   2   2   2   2 101
101   2   2   2   2   2   2   2   2   2   2   2   2   2   2   2   2   2   2   2 101   2 111 100 108   2 111 100 112   2 110   2 111 100 112   2 107 100 112   2 101   2   2   2   2   2   2   2   2   2   2   2   2   2   2   2   2   2   2   2 101
101   3   2   2   2   2   2   2   2   2   2   2   2   2   2   2   2   2   2   2 101   3   2   2 101   2   2   2   2   2   0   2   2   2   2   2 101   2   2   3 101   2   2   2   2   2   2   2   2   2   2   2   2   2   2   2   2   2   2   3 101
101   2   2   2   2   2   2   2   2   2   2   2   2   2   2   2   2   2   2   2 131 100 112   2 110   2 113   2 111 100 133 100 112   2 113   2 110   2 111 100 132   2   2   2   2   2   2   2   2   2   2   2   2   2   2   2   2   2   2   2 101
101   2   2   2   2   2   2   2   2   2   2   2   2   2   2   2   2   2   2   2 101   2   2   2   2   2 101   2   2   2 101   2   2   2 101   2   2   2   2   2 101   2   2   2   2   2   2   2   2   2   2   2   2   2   2   2   2   2   2   2 101
101   2   2   2   2   2   2   2   2   2   2   2   2   2   2   2   2   2   2   3 110   2 111 100 100 100 130 100 112   2 110   2 111 100 130 100 100 100 112   2 110   3   2   2   2   2   2   2   2   2   2   2   2   2   2   2   2   2   2   2 101
101   2   2   2   2   2   2   2   2   2   2   2   2   2   2   2   2   2   2   2   2   2   2   2   2   3   2   2   2   2   2   2   2   2   2   3   2   2   2   2   2   2   2   2   2   2   2   2   2   2   2   2   2   2   2   2   2   2   2   2 101
101   2   2   2   2   2   2   2   2   2   2   2   2   2   2   2   2   2   2   2   2   2   2   2   2   2   2   2 111 100 133 100 112   2   2   2   2   2   2   2   2   2   2   2   2   2   2   2   2   2   2   2   2   2   2   2   2   2   2   2 101
101   3   2   2   2   2   2   2   2   2   2   2   2   2   2   2   2   2   2   2   2   2   2   2   2   2   2   2   2   2 101   2   2   2   2   2   2   2   2   2   2   2   2   2   2   2   2   2   2   2   2   2   2   2   2   2   2   2   2   3 101
101   2   2   2   2   2   2   2   2   2   2   2   2   2   2   2   2   2   2   2   2   2   2   2   2   2   2 100 112   2 110   2 111 100   2   2   2   2   2   2   2   2   2   2   2   2   2   2   2   2   2   2   2   2   2   2   2   2   2   2 101
101   2   2   2   2   2   2   2   2   2   2   2   2   2   2   2   2   2   2   2   2   2   2   2   2   2   2   2   2   2   2   2   2   2   2   2   2   2   2   2   2   2   2   2   2   2   2   2   2   2   2   2   2   2   2   2   2   2   2   2 101
101   2   2   2   2   2   2   2   2   2   2   2   2   2   2   2   2   2   2   3   2   2   2   2   2   3   2   2 111 100 133 100 112   2   2   3   2   2   2   2   2   3   2   2   2   2   2   2   2   2   2   2   2   2   2   2   2   2   2   2 101
101   2   2   2   2   2   2   2   2   2   2   2   2   2   2   2   2   2   2   2   2   2   2   2   2   2   2   2   2   2 101   2   2   2   2   2   2   2   2   2   2   2   2   2   2   2   2   2   2   2   2   2   2   2   2   2   2   2   2   2 101
101   2   2   2   2   2   2   2   2   2   2   2   2   2   2   2   2   2   2   2   2   2   2   2   2   2   2 100 112   2 110   2 111 100   2   2   2   2   2   2   2   2   2   2   2   2   2   2   2   2   2   2   2   2   2   2   2   2   2   2 101
101   3   2   2   2   2   2   2   2   2   2   2   2   2   2   2   2   2   2   2   2   2   2   2   2   2   2   2   2   2   2   2   2   2   2   2   2   2   2   2   2   2   2   2   2   2   2   2   2   2   2   2   2   2   2   2   2   2   2   3 101
105 100 100 100 100 100 100 100 100 100   0 100 100 100 100 100 100 100 100 100   0 100 100 100 100 100 100 100 100 112   0 111 100 100 100 100 100 100 100 100   0 100 100 100 100 100 100 100 100 100   0 100 100 100 100 100 100 100 100 100 106
