num_pellets 81
pacman_home (9 * 16, 9 * 16)
ghost_home [(2 * 16, 3 * 16), (1 * 16, 1 * 16), (2 * 16, 1 * 16), ( 3 * 16, 1 * 16)]
level_dim (15, 15)
color_edge (0, 0, 255, 255)
color_fill (0, 0, 0, 255)
color_shadow (0, 0, 128, 255)
color_pellet (255, 255, 255, 255)
107 100 100 100 133 100 100 100 100 100 100 100 100 100 108
101   0   0   0 101   2   2   2   2   2   2   2   2   2 101
131 100   1 100 132   2 107 100 108   2 107 100 108   2 101
101   0   0   0 101   2 101   0 101   2 101   0 101   2 101
131 100 100 100 106   2 105 100 106   2 105 100 106   2 101
101   2   2   2   2   2   2   2   2   2   2   2   2   2 101
101   2 107 100 108   2 107 100 108   2 107 100 108   2 101
101   2 101   0 101   2 101   0 101   2 101   0 101   2 101
101   2 105 100 106   2 105 100 106   2 105 100 106   2 101
101   2   2   2   2   2   2   2   2   2   2   2   2   2 101
101   2 107 100 108   2 107 100 108   2 107 100 108   2 101
101   2 101   0 101   2 101   0 101   2 101   0 101   2 101
101   2 105 100 106   2 105 100 106   2 105 100 106   2 101
101   2   2   2   2   2   2   2   2   2   2   2   2   2 101
105 100 100 100 100 100 100 100 100 100 100 100 100 100 106
